11111111111111111111111111111111111111111111111111111111111111111111111111111111111111111111111
1.....................1.......................................................................1
1.....................1.......................................................................1
1.....................1..................................................................M....1
1.........M...........1.......................................................................1
1.....................1.......................................................................1
1.....................1.......................................................................1
1.....................1.......................................................................1
1.....................1...............1.......................................................1
1.....................1...............1...................................111111111111111111111
1.....................1..............11............1..........................................1
1....................................11............11.........................................1
1...................................11..............11........................................1
1..................................11................11.......................................1
1.................................11..................11......................................1
1................................11..............P............................................1
1...............................11............................................................1
1..............................11.............................................................1
1.............................11.................111..........................................1
1............................11................111............................................1
1...........................11...............111..............................................1
1..........................11..............111................................................1
1.............................................................................................1
1..............................................................................1..............1
1........................................................111111................1..............1
1........................................................111111................1..............1
1111111111111111111111111................................111111................1..............1
1........................................................111111................1..............1
1........................................................111111................1..............1
1.......M................................................111111................1..............1
1..............................................................................1..............1
1..............................................................................1........M.....1
1..............................................................................1..............1
11111111111111111111111111111111111111111111111111111111111111111111111111111111111111111111111
